1111111111111
1C01000C000C1
1000101111011
111000P10E001
1111111111111
