1111111111111
1C01000C0P0C1
1000101111011
111000010E001
1111111111111
