1111111111111
1C0100C0000C1
1000011111001
1000110000001
1111111111111
