1111111111111
10010000000C01
100001111100001
1P0011E000000001
11111111111111111
